# Ini adalah komentar
# Daftar tile: 
# (Space) Tile kosong
# (A..M)  Tile A sampai M.
# l       Live Up.
# s       Waskita. Untuk menambah MP
# k       Kendi. Untuk menambah HP
# l       Buto Ijo
# 2       Buto Abang
# 3       Nagapecona(BOSS)
                                                                                                                                                                                                                                                                                  G                                   
                                                                                                                                                                                                                                                                                  G                                   
                                                                                                                                                                                                                                                                                  G                                   
                                                                                                                                                                                                                                                                                  G                                   
                                                                                                                                                                                                                                                                                  G                                   
                                                                                                                                                                                                                                                                                  G                                   
                                                                                                                                                                                                                                                                                  G                                   
                                                                                                                                                                                                                                                                                  G                                   
                                                                                                                                                                                                                                                                                  G                                   
                                                                                                                                                                                                                                                                                  G                                   
                                                                                                                                                                                                                                                                                  G                                   
                                                                                                                                                                                                                                                                                  G                                   
                                                                                                                                                                                                                                                                                  G                                   
                                                                                                                                                                                                                                                                               s  G                                   
                                                                                                                                                                                                                                                                               s  G                                   
                                                                                                                                                                                                                                                                               s  G                                   
                                                                                                                                                                                                                                                                               s  G                                   
                                                                                                                                                                                                                                                                               s  G                                   
                                                                                                                                                                                                                                                                             s s sG                                   
                                                                                                                                                                                                                                                                              sss G                                   
                                             s                                                                                                                                                                                                                                 s  G                                   
                                             s                                                                                                                                                                                                                                    G                                   
                          1  1  1  1   k   s s s                                                              IBAJ                                                                                               IBAJ                                                             G                                   
              IBABABABABABABABABABABABABAJ  sss                                                               MMLL                                                                                               MMLF            IBAJ                                  IBABAJ     G                                   
              EMLMLMLMLMLMLMLMLMLMLMLMLMLF   s                                                        IBAJ            IBAJ                                                                               IBAJ       H   2        ELMF                                 2ELMLMF     G                                   
IBABABABAJ    G                          H                                                            MMLL            MMLL                                                                               MMLL       HBABABABABABAG  H                            IBABABG    H     G                                   
LMLMLMLMLF    G                          H                                                    IBAJ                            IBAJ                                                               IBAJ               DLMLMLMLMLMLMC  H                           2ELMLMLC    H     G                                   
         H    G                          H                                                    MMLL                            MMLL                                                               MMLL                               H                      IBABABG          H     G                                   
         H    G                          H                                            IBAJ                                            IBAJ                                               IBAJ                                       H       1 1 1 1 1 1 1 1ELMLMLC          H     G                                   
         H    G                          H           2                                MMLL                                            MMLL                                               MMLL                                       HBABABABABABABABABABABAG                H     G                                   
         H    G                          HBABABABABABABABABABABAJ    IBABABABABABA                                                            IBAJ                               IBAJ                                               DLMLMLMLMLMLMLMLMLMLMLMC                H     G                                   
         H    G                          DLMLMLMLMLMLMLMLMLMLMLMF    ELMLMLMLMLMLM        IBAJ                                                MMLF            IBAJ               MMLL                                                                                       H                                         
         H    G                                                 H ss G                    MMLL                                                   H   2        ELMF       IBAJ                                                                                               H                                         
         H    G                                                 HBABAG                            IBAJ                                           HBABABABABABAG  H       MMLL        IBAJ                                H                                                  H                                         
         H    G                                                 DLMLMC                            MMLL                                           DLMLMLMLMLMLMC  HBAJ                MMLL                                H                                                  H                                         
         H    G                                                                                                                                                  DLMM                        IBAJ                        H                                                  H                                         
         H    G                                                                               IBAJ                                                                                           MMLL                        H                                                  H                                         
         H    G                                                                               MMLL                                                                                                                       H                                                  H                                         
         H    G                                                                                                                                                                          IBAJ                            H                                                  H                                         
         H    G                                                                           IBAJ                                                                                           MMLL                            H                                                  H                                         
         H    G                                                                           MMLL                                                                                                                           H                                                  H                                         
         H    G                                                                   IBAJ                                                                                               IBAJ                                H                                                  H                                         
         H    G                                                            l      MMLL                                                                                               MMLL                                H                                                  H                                         
         H    G                                                           IBAJ                                                                                               IBAJ                                        H                                                                                            
         H    G                                                           MMLL                                                                                               MMLL                                        H                                                                                            
         H    G                                                                                                                                                      IBAJ                                                H                                                                                            
         H    G                                                                                                                                                      MMLL                                                H                                                                                            
         H    G                                                                                                                                              IBAJ                                                        HBABABABABABABABABABABABABABABABABABABABABABABABABAJ                                         
         H    G                                                                                                                                              MMLL                                                        DLMLMLMLMLMLMLMLMLMLMLMLMLMLMLMLMLMLMLMLMLMLMLMLMLMF                                         
         H    G                                                                                                                                                                                                                                                             HBAJ                                      
         H    G                                                                                                                                                  IBAJ                                                                                                       DLMF                                      
         H    G                                                                                                                                                  MMLL                                                                                                          HBAJ                                   
         H    G                                                                                                                                                          IBAJ                                                                                                  DLMF                                   
         H    G                                                                                                                                                          MMLL                                                                                                     HBAJ                                
         H    G                                                                                                                                                                  IBAJ                                                                                             DLMF                                
         H    G                                                                                                                                                                  MMLL                                                                                                HBAJ                             
         H    G                                                                                                                                                                          IBAJ                                                                                        DLMF                             
         H    G                                                                                                                                                                          MMLL                                                                                           HBAJ                          
         H    G                                                                                                                                                                                                                                                                         DLMF                          
         H    G                                                                                                                                                                      IBAJ                                                                                                  HBAJssssIBABABABABABABABABA
         H    G                                                                                                                                                                      MMLL                                                                                                  DLMFssssELMLMLMLMLMLMLMLMLM
         H    G                                                                                                                                                              IBAJ                                                                                                             H    G                  
         H    G                                                                                                                                                              MMLL                                                                                                             H    G                  
         H    G                                                                                                                                                      IBAJ                                                                                                                     H    G                  
         H    G                                                                                                                                                      MMLL                                                                                                                     H    G                  
         H    G                                                                                                                                              IBAJ                                                                                                                             H    G                  
         H    G                                                                                                                                       ll     MMLL                                                                                                                             H    G                  
         H    G                                                                                                                                      IBAJ                                                                                                                                     H    G                  
         H    G                                                                                                                                      MMLL                                                                                                                                     H    G                  
         H    G                                                                                                                                                                                                                                                                               H    G                  
         H    G                                                                                                                                                                                                                                                                               H    G                  
         H    G                                                                                                                                                                                                                                                                               H    G                  
         H    G                                                                                                                                                                                                                                                                               H    G                  
         H    G                                                                                                                                                                                                                                                                               H    G                  
         H    G                                                                                                                                                                                                                                                                               H    G                  
         H    G                                                                                                                                                                                                                                                                               H    G                  
         H    G                                                                                                                                                                                                                                                                               H    G                  
         H    G                                                                                                                                                                                                                                                                               H    G                  
         H    G                                                                                                                                                                                                                                                                               H    G                  
         H    G                                                                                                                                                                                                                                                                               H    G                  